1 8 8
########
#.    .#
#  00  #
#1     #
#  00  #
#      #
#.    .#
########
2 9 9
#########
#...# 1 #
# . #   #
#   # 0 #
## ## 0 #
#     0 #
#    0  #
#       #
######### 