13 13
#############
#        .  #
#           #
###### ######
#           #
#  0        #
#    ###    #
#           #
###       ###
#    ###    #
#           #
##  A      ##
#############